1111111111111111111111111111111111
100C00000000000C00000C0000001E1001
1010010100100000101001000000010101
10100100111010100C1001000000010101
1P0000000C00000000000000C0000000C1
1111111111111111111111111111111111